1111111111111111111111
1P00000013100000000001
1C00000000100000000001
1111111100111000000001
10001CC100000000000001
10001001000000E0000001
1000100100000000000001
1000100100000000000001
11C0000003000000000001
1C00000000000000400001
1111111111111111111111