1111111
1P00001
1111001
1C000E1
1111111